369,369,369,305,371,371,303,369,369,369
369,369,369,305,371,371,303,369,369,369
369,369,369,305,371,371,303,369,369,369
336,336,336,337,371,371,335,336,336,336
371,371,371,371,371,371,371,371,371,371
371,371,371,371,371,371,371,371,371,371
371,371,371,371,371,371,371,371,371,371
371,371,371,371,371,371,371,371,371,371
371,371,371,371,371,371,371,371,371,371
371,371,371,371,371,371,371,371,371,371
