367,367,367,326,371,371,324,367,367,367
367,367,367,326,369,371,324,367,367,367
367,367,367,326,371,371,324,367,367,367
346,346,346,347,371,371,345,346,346,346
371,371,371,371,371,371,369,371,371,371
371,369,371,371,371,371,371,371,371,371
304,304,304,305,370,371,303,304,304,304
367,367,367,326,370,371,324,367,367,367
367,367,367,326,370,369,324,367,367,367
367,367,367,326,370,371,324,367,367,367
